..############...##############.
..##........##....##........####
##..##......##..####......##..##
##....##..........##....##....##
##.......#..####..##..##......##
##........####....####........##
##..###########..###############
##..##......##....##........####
........##..##.......S..##......
#####.##########################
##........####....###.........##
##......##..########F.##......##
##..##............#####..#.....#
##..##...#####..####......######
####........##..............#...
.##############.#############...

